NO map_textures/north_texture
SO map_textures/south_texture
WE map_textures/west_texture
EA map_textures/east_texture

F 220,100,0
C 225,30,0



111111111111111
1N0000000000011
100000000000101
100000000001001
100000000010001
100000000100001
100000001000001
100000010000001
111111111111111
