NO map_textures/north_texture
SO map_textures/south_texture
WE map_textures/west_texture
EA map_textures/east_texture

F 220,100,0
C 225,30,0



111111111
1N0000001
101111101
101   101
101 11101
101   101
101111101
100000001
111111111