NO map_textures/north_texture
SO map_textures/south_texture
WE map_textures/west_texture
EA map_textures/east_texture

F 220,100,0
C 225,30,0



1111111111111111111
1N00000000000000001
1000000000100100001
1000000000000000001
1000000000100100001
1000000000000000001
1011111000000100001
1000000000000100001
1111111111111111111














