NO map_textures/north_texture
SO map_textures/south_texture
WE map_textures/west_texture
EA map_textures/east_texture

F 220,100,0
C 225,30,0



11111111111
1N000010001
10111111101
101     101
101 111 101
101 101 101
101 111 101
101     101
10111111101
10000010001
11111111111