NO map_textures/north_texture
SO map_textures/south_texture
WE map_textures/west_texture
EA map_textures/east_texture

F 220,100,0
C 225,30,0



1111111111
1N00000001
1011111101
101   1101
101  1 101
101    101
1011111101
1000000001
1111111111