NO map_textures/north_texture
SO map_textures/south_texture
WE map_textures/west_texture
EA map_textures/east_texture

F 220,100,0
C 225,30,0


1111111111
1000000001
10000000011
1000000000N1
111111111111