NO map_textures/north_texture
SO map_textures/south_texture
WE map_textures/west_texture
EA map_textures/wall.xpm

C 0,0,255
F 255,0,0

1111111111111111111111111
1000000000110000000000001
1001000001110000000000001
1001000000000N00000000001
1001000000000000010000001
1000000000000000000000001
1000000010000000100000001
1000000000000000000000001
1001000000000000000000001
1000000000000000000000001
1000000000000100000000001
1001000000000000000000001
1000000000000000000000001
1000000000000000000000001
1000000000000000000000001
1111111111111111111111111
