NO map_textures/north_texture
SO map_textures/south_texture
WE map_textures/west_texture
EA map_textures/east_texture

C 0,0,255
F 255,0,0

11111111111111111111111111111111
10000000000000000000000000000001
100000000000000000N0000000000001
10000000000000000000000000000001
11111111111111111111111111111111
