NO map_textures/steel_wall.xpm
SO map_textures/steel_wall2.xpm
WE map_textures/steel_wall3.xpm
EA map_textures/wall.xpm

C 0,0,100
F 50,60,70


11111111111111111111
10000000001100000001
10010000011100000001
1001000000000000000111111
1001000000000000000000001 
1000000000000000000000001
1000000010000000000000001
1000000000000000000000001
1E00001000000000000000001
1000000000000000000000001
1111111111111111111111111
