NO map_textures/600x600/north_texture
SO map_textures/600x600/south_texture
WE map_textures/600x600/west_texture
EA map_textures/600x600/east_texture

C 0,0,255
F 255,0,0

111111111111111111111111111111
100000000000000000000000000001
100000000000000000000000000S01
100000000000000000000000000001
111111111111111111111111111111
