NO map_textures/north_texture
SO map_textures/south_texture
WE map_textures/west_texture
EA map_textures/washer.xpm

F 220,100,0
C 225,30,0

1111111111111111111111111
100000000011N000000000001
1001000001110000000000001
1001000000000000000000001
1000000000000000000000001
1000000000000000000000001
1000000000000000000000001
1000000000000000000000001
1000000000000000000000001
1000000000000000000000001
1000000000000000000000001
1000000000000000000000001
1000000000000000000000001
1000000000000000000000001
1000000000000000000000001
1111111111111111111111111
