NO map_textures/north_texture
SO map_textures/south_texture
WE map_textures/west_texture
EA map_textures/east_texture

C 0,255,0
F 255,0,0

1111111111111111111111111
1000000000110000000000001
1001000001110000000000001
1001000000000000000000001
1001000000000000000000001
1000000000000000000000001
1000000010000000000000001
1000000000000000000000001
1E00001000000000000000001
1000000000000000000000001
1111111111111111111111111
