NO map_textures/north_texture
WE map_textures/west_texture
SO map_textures/south_texture
EA map_textures/east_texture
C  0,0,255
F  255,0,0

        1111111111111111111111111
        1000000000110000000000001
        10110000011100000000000011   
        1001000000000000000N000001
        11111111111111111111111111111
1111111110110000011100000000000010001
1000000000110000011101111111111111111
11110111111111011100000010001   1
11110111111111011101010010001   1
11000000110101011100000010001
10000000000000011000000100011
1000000000000000110101001000111
11000001110101011111011110011
11110111 1110101 101111010001
11111111 1111111 111111111111