NO map_textures/north.xpm
WE     map_textures/west.xpm
SO map_textures/south.xpm
EA map_textures/east.xpm
C   0,0,255
F      255,0,0

111 
101 
111 
       11111111111111111111111111
        1000000000110000000000001
        1011000001110000000000001
        1001000000000000000000001
        1111111111111111111111111
111111111011000001110000000000001
100000000011000001110111111111111
11110111111111011100000010001   1
11110111111111011101010010001   1
11000000110101011100000010001
10000000000000011000000100011
1000000000000000110101001000111
11000001110101011111011110N01
11110111 1110101 101111010001
11111111 1111111 111111111111
